######################
#1    #       #      #
# #   ###   #### #####
# #                  #
#    p #  p  #  ### ##
##########           #
# #     #   ####    ##
# p                  #
# #######   #######  #
#    #  #   #p       #
# ####  #   ### ###  #
#    #    #         2#
######################