##################
#1    #       #  #
# #   ###  p###  #
# #              #
#    p #  p  #  2#
##################